朝のカフェでパソコンを使っている	午前中に作業している人	夜の映画館でくつろいでいる
30代男性が仕事前にコーヒーを飲んでいる	会社に出勤する前のルーティン	遊園地で絶叫マシンに乗っている
夜、リビングで家族とテレビを見ている	夜の団らんを楽しんでいる	通勤ラッシュで満員電車に乗っている
公園で犬を散歩している	晴れた日の朝に散歩する	深夜にバーでお酒を飲んでいる
雨の日に室内で読書をしている	雨の日の静かな過ごし方	快晴の海辺で泳いでいる
カフェで勉強している大学生	図書館で参考書を読む学生	観光地でお土産を探している旅行客
午後のオフィスで会議している	社内ミーティングのシーン	寝室で眠っている
朝食を作っている主婦	朝の台所で料理する	真夜中にゲームをしている子供
図書館で静かに作業している人	集中して資料を読む人	遊園地で騒ぐ子供たち
リモート会議に参加している	Web会議に出席中のビジネスマン	登山中に頂上を目指している
昼の公園で子供と遊ぶ母親	日中に屋外で子供と遊ぶ	ビジネスホテルで会議している
夜中にベッドでスマホを見ている	就寝前のスマホチェック	ジムで筋トレをしている
在宅勤務中のリモート作業風景	自宅でパソコン作業している人	祭りで屋台を楽しむ人々
スーパーで買い物をしている主婦	日常の買い物シーン	飛行機で海外旅行に出かける
早朝にジョギングしている男性	朝の運動習慣	夜中に映画を見ている若者
教室で授業を受ける高校生	授業中に真剣な眼差しを向ける学生	山小屋で星を眺めている登山者
深夜にコンビニで買い物をしている	夜更かし中の軽食調達	昼間のビーチで日焼けしている
ビジネスマンが昼食をとっている	ランチタイムの食事風景	遊園地でジェットコースターに乗る
駅のホームで電車を待っている通勤客	朝の通勤風景	結婚式場で祝福される新郎新婦
午後に図書館で勉強している大学生	静かな場所で集中して学ぶ	キャンプ場でバーベキューしている
